...1...........................................
...11111111111111..............................
1111............11111111111111.................
1............................111...............
111............................................
1..............................................
111111111111111111111111111....................
..................1............................
1111111111111111111............................
..................1............................
..................11111111.....................
..........111111111......111111111.............
.................................1.............
